Columns: 20
Rows: 20
11111111111111111111
10000000000000000001
10111011100111011101
10111011100111011101
10000000000000000001
10111011111111011101
10000000000000000001
10111011100111011101
10111010000001011101
10111011111111011101
10000000000000000001
10111011100111011101
10111011111111011101
10111011111111011101
10000011111111000001
10111000000000011101
10000011111111000001
10111000000000011101
10000000000000000001
11111111111111111111